ctrai	con trai
khôg	không
bme	bố mẹ
cta	chúng ta
mih	mình
mqh	mối quan hệ
cgai	con gái
nhữg	những
mng	mọi người
svtn	sinh viên tình nguyện
qtam	quan tâm
thươg	thương
qtâm	quan tâm
chug	chung
trườg	trường
thoy	thôi
đki	đăng ký
atsm	ảo tưởng sức mạnh
đẹplawsm	đẹp lắm
ạk	ạ
vch	vãi chưởng
cùg	cùng
pn	bạn
pjt	biết
trawngd	trắng
hoie	hơi
đjawt	đặt
thumif	thôi
cx	cũng
dubwgf	dừng
nhanhhhhhhhhhhhhhhhhhhhhhhhhyyhhhhhhhhhhhhhhhhhhhhhhhhhhhhhhhhh	nhanh
okokokokokokokokokokokok	ok
okeeeeeeeeeeeeeeeeeeeeeeee	ok
okelaaaaaaaaaaaaaaaaaaaaaaaaaaa	ok
khum	không
xấuhhhhhhhhghgggghhhhhhhhhhhhh	xấu
vàngkwosjxjd	vàng
thjk	thích
quyétttttttttyttttt	quyết
keke	cười
ktra	kiểm tra
nek	nè
cgái	con gái
nthe	như thế
chúg	chúng
kái	cái
tìh	tình
phòg	phòng
lòg	lòng
từg	từng
rằg	rằng
sốg	sống
thuj	thôi
thuơng	thương
càg	càng
đky	đăng ký
bằg	bằng
sviên	sinh viên
ák	á
đág	đáng
nvay	như vậy
nhjeu	nhiều
xg	xuống
zồi	rồi
trag	trang
zữ	dữ
atrai	anh trai
kte	kinh tế
độg	động
fai	phải
lmht	liên minh huyền thoại
gắg	gắng
đzai	đẹp trai
thgian	thời gian
plz	pờ ly
đồg	đồng
btrai	bạn trai
nthê	như thế
hìhì	hì hì
vọg	vọng
hihe	hi he
đôg	đông
răg	răng
thườg	thường
tcảm	tình cảm
đứg	đứng
ksao	không sao
dz	đẹp trai
hjxhjx	hix hix
cmày	chúng mày
xuốg	xuống
nkư	như
lquan	liên quan
tiếg	tiếng
hajz	hai
xih	xinh
hìh	hình
thàh	thành
ngke	nghe
dzậy	dậy
teencode	tin cốt
tnào	thế nào
tưởg	tưởng
ctrinh	chương trình
phog	phong
hôg	không
zìa	gì
kũg	cũng
ntnao	như thế nào
trọg	trọng
nthế	như thế
năg	năng
ngđó	người đó
lquen	làm quen
riêg	riêng
ngag	ngang
hêhê	hê hê
bnhiu	bao nhiêu
ngốk	ngốc
kậu	cậu
kqua	kết quả
htrc	hôm trước
địh	định
gđình	gia đinh
giốg	giống
csống	cuộc sống
xug	xùng
zùi	rồi
bnhiêu	bao nhiêu
cbị	chuẩn bị
kòn	còn
buôg	buông
csong	cuộc sống
chàg	chàng
chăg	chăng
ngàh	ngành
llac	liên lạc
nkưng	nhưng
nắg	nắng
tíh	tính
khoảg	khoảng
thík	thích
ngđo	người đó
ngkhác	người khác
thẳg	thẳng
kảm	cảm
dàh	dành
júp	giúp
lặg	lặng
vđê	vấn đề
bbè	bạn bè
bóg	bóng
dky	đăng ký
dòg	dòng
uốg	uống
tyêu	tình yêu
snvv	sinh nhật vui vẻ
đthoại	điện thoại
qhe	quan hệ
cviec	công việc
tượg	tượng
qà	quà
thjc	thích
nhưq	nhưng
cđời	cuộc đời
bthường	bình thường
zà	già
đáh	đánh
xloi	xin lỗi
zám	dám
qtrọng	quan trọng
bìh	bình
lzi	làm gì
qhệ	quan hệ
đhbkhn	đại học bách khoa hà nội
kủa	của
đhkhtn	đại học khoa học tự nhiên
đóg	đóng
cka	cha
lgi	làm gì
lz	tệ
nvậy	như vậy
qả	quả
đkiện	điều kiện
nèk	nè
tlai	tương lai
bsĩ	bác sĩ
hkì	học kỳ
đcsvn	đảng cộng sản việt nam
vde	vấn đề
chta	chúng ta
òy	rồi
ltinh	linh tinh
ngyeu	người yêu
đthoai	điện thoại
snghĩ	suy nghĩ
nặg	nặng
họk	học
dừg	dừng
hphúc	hạnh phúc
hiha	hi ha
wtâm	quan tâm
thíck	thích
chuện	chuyện
lạh	lạnh
fây	phây
ntnày	như thế này
lúk	lúc
haj	hai
ngía	nghía
mớj	mới
hsơ	hồ sơ
ctraj	con trai
nyêu	người yêu
điiiiiii	đi
rồii	rồi
c	chị
kih	kinh
kb	không biết
hixxx	hích
dthương	dễ thương
nhiềuuu	nhiều
ctrình	chương trình
mìnk	mình
mjh	mình
ng	người
uhm	ừm
thỳ	thì
nyc	người yêu cũ
tks	cảm ơn
nàg	nàng
thôii	thôi
đjên	điên
bgái	bạn gái
vớii	với
xink	xinh
hđộng	hành động
đhọc	đại học
mk	mình
bn	bao nhiêu
thik	thích
cj	chị
muannxnccnncncnccnnccnncxnnxxnnxnxxnnxnxnxnxnxnxnxnxnnn	mua
okokokokokokokokokokokkokokokokokokokook	ok
okokokokokokokokokokokokokokokokokokokokokok	ok
điẹp	đẹp
okomkkkkkkkkkkkkkkkk	ok
recommend	đề xuất
củ	cũ
gứi	gửi
lèm	lem
wa	quá
wá	quá
tl	trả lời
huhuhuhuhuhuhuhuhuhuhuhu	khóc
vưaaa	vừa
nhưnh	nhưng
nhanb	nhanh
lâujjdnrkdjdkdfnkdjdjdjkxdkndjc	lâu
mn	mọi người
nguoi	người
nógn	nóng
hok	không
ko	không
bik	biết
vs	với
cx	cũng
mik	mình
wtf	what the fuck
đc	được
cmt	comment
ck	chồng
chk	chồng
ngta	người ta
gđ	gia đình
oh	ồ
vk	vợ
ctác	công tác
sg	sài gòn
ae	anh em
ah	à
ạh	ạ
rì	gì
vn	việt nam
nhaa	nha
cũg	cũng
khôbg	không
đag	đang
ơiii	ơi
ace	anh chị em
àk	à
uh	ừ
thg	thường
hsau	hôm sau
htr	hôm trước
cmm	con mẹ mày
cmnr	con mẹ nó rồi
ơiiii	ơi
hnay	hôm nay
ukm	ừm
tq	trung quốc
ctr	chương trình
đii	đi
nch	nói chuyện
trieu	triệu
hahah	ha ha
nta	người ta
ngèo	nghèo
kêh	kênh
ak	à
ad	quản trị viên
j	gì
ny	người yêu
dc	được
qc	quảng cáo
baoh	bao giờ
zui	vui
zẻ	vẻ
tym	tim
aye	anh yêu em
eya	em yêu anh
fb	facebook
insta	instagram
z	vậy
thich	thích
vcl	vờ cờ lờ
đt	điện thoại
acc	account
loz	lồn
lozz	lồn
trc	trước
chs	chẳng hiểu sao
đhs	đéo hiểu sao
qá	quá
ntn	như thế nào
wá	quá
zậy	vậy
zô	vô
ytb	youtube
vđ	vãi đái
vchg	vãi chưởng
sml	sấp mặt lờ
cmn	con mẹ nó
face	facebook
hjhj	hi hi
vv	vui vẻ
ns	nói
iu	yêu
vcđ	vãi cả đái
in4	info
qq	quần què
sub	subcribe
kh	không
zạ	vậy
oy	rồi
jo	giờ
clmm	cái lồn mẹ mày
bsvv	buổi sáng vui vẻ
troai	trai
wa	quá
hjx	hix
e	em
ik	ý
ji	gì
ce	chị em
lm	làm
đz	đẹp giai
sr	sorry
ib	inbox
hoy	thôi
đbh	đéo bao giờ
k	không
vd	ví dụ
a	anh
pải	phải
z	vậy
cty	công ty
cb	chuẩn bị
kô	không
đtqg	đội tuyển quốc gia
hqua	hôm qua
xog	xong
uh	ừ
uk	ừ
nhoé	nhé
biet	biết
quí	quý
stk	số tài khoản
hong kong	hồng kông
đươc	được
nghành	ngành
nvqs	nghĩa vụ quân sự
ngừoi	người
trog	trong
tgian	thời gian
biêt	biết
fải	phải
nguời	người
tđn	thế đéo nào
bth	bình thường
vcđ	vãi cả đái
tgdd	thế giới di động
khg	không
nhưg	nhưng
thpt	trung học phổ thông
thằg	thằng
đuợc	được
dc	được
đc	được
ah	à
àh	à
ku	cu
thým	thím
onl	online
zô	dô
zú	vú
cmnd	chứng minh nhân dân
sđt	số điện thoại
klq	không liên quan
ks	khách sạn
note	chú ý
chill	rất thư giãn và dễ chịu
terrable	chịu đựng
kg	không
hanoi	hà nội
frienfs	những người bạn
tphcm	thành phố hồ chí minh
mấyyy	mấy
uổn	uổng
okeee	ok
sz	size
tb	trung bình
bbuoi	buổi
szL	size L
ổnnnnnnnnnnnnnnnnnnnnnnnnnnnnnnnnnnnnnnnnnnnnnnnnnntt	ổn
đx	được
nhma	nhưng mà
vãi	vải
rep	trả lời
đk	được
nónggggggg	nóng
tìmh	tình
gẫy	gãy
đaamj	đậm
mỏngggggggggg	mỏng
toyy	tôi
gứi	gửi
gữi	gửi
òi	rồi
xứt	sứt
oont	ổn
dãn	giãn
ngắnnnnn	ngắn
mấyyyy	mấy
sida	cũ
qá	quá
côg	công
okeee	ok
on	ổn
dep	đẹp
nen	nên
vllllllllllllllllllllllllllllllllllllllll	vờ lờ
khong	không
sahop	shop
trk	trước
r	rồi
bjo	bây giờ
tl	trả lời
vưa	vừa
shoo	shop
sp	sản phẩm
cap	chụp
5sao	5 sao
hài vc	hài vãi chưởng
mngui	mọi người
nhaaa	nha
nma	nhưng mà
:(	buồn
spt	sản phẩm
tìnhhh	tình
nheee	nhe
:)	cười
ahuhu	khóc
nh mà	nhưng mà
cuzng	cũng
cskh	chăm sóc khách hàng
đieerm	điểm
siuuu	siêu
ơiiii	ơi
rấc	rất
siêuu	siêu
nênn	nên
mõng	mỏng
m.n	mọi người
sản phâmt	sản phẩm
vl	vờ lờ
cc	cờ cờ
đm	đờ mờ
típ	tiếp
pahamr	phẩm
đẹppppppppppppp	đẹp
nhanhhhhhhhhhhhhhhhhhhhhhhhhhhhhhh	nhanh
vid	video
tc	tính chất
tv	tư vấn
oce	được
@@	ngạc nhiên
cacban	các bạn
dút	rút
4*	4 sao
giải guyết	giải quyết
tất chơn	tất trơn
gía	giá
nhiêug	nhiều
sịn	xịn
gioa	giao
chats	chất
hỏngvffvcdvv	hỏng
dubv tam	dùng tạm
thankssssssssssss	cảm ơn
shoppppppppppp	shop
:3	cười
<3	yêu
cực kìiii	cực kỳ
nvghkem	nhân viên giao hàng kém
:v	cười
đell	đéo
seri	size
lũng	lủng
*	sao
lămz	lắm
xuuu	xu
thrrm	thêm
kp	không phải
dống	giống
gòiiiiiiiiiiiiii	rồi
nữaaaaaaaaaaaaaaaaaaaaaaaaa	nữa
tiếpppp	tiếp
lunnn	luôn
uho	ủng hộ
rất rông	rất rộng
co dãn	co giãn
gião	dão
sắccccc	sắc
okeeeeeeeeeeeeeeeeeeeeeeeeeeeeeeeeeeeeee	ok
biewts	biết
okkkkkkkkkkkkk	ok
okkkkkkkk	ok
nà mỏng	mà mỏng
qte	quốc tế
okkkkk	ok
haizzzzzz	thở dài
hỏn	hỏng
monfvaf	mòn và
gẫy	gãy
gảy	gãy
đẹp lám	đẹp lắm
muaaaaaa	mua
tn	tin nhắn
nt	nhắn tin
bgio	bao giờ
tnay	thế này
gở	gỡ
shopp	shop
xíuu	xíu
uiii	ôi
oiii	ơi
nnay	này
xối zách	số dách
hợp lí	hợp lý
lí do	lý do
kooooooooooooooooooooooooooooooo	không
haiiiiiiiiiiiiiiiiiiiiiiiiiiiiiiiiiiiiiiiiiiiiiiiiiiiiiiiiiiiiiiiiiiiiiiiii	hài
longggggggggggggggggggggggggggg	lòng
lammmmmmmmmmmmmmmmmmmm	lắm
ômm	ôm
thiwjc	thực
bthg	bình thường
ôn bụng	ôm bụng
chacs	chắc
caooo	cao
cuteee	dễ thương
huhuu	khóc
zừa	vừa
haizz	thở dài
midnh	mình
ơiiiiiiiii	ơi
feedbacks	phản hồi
nhậnnnnnnnnnnnnnnnnnnnnnnnnn	nhận
dx	được
vll	vờ lờ
sall	giảm
ax	chồng
kpit	không biết
điiii	đi
UwU	cười
siuu	siêu
áaa	á
muaaa	mua
đâuu	đâu
chất vả	chất vải
họpe	hợp
nà	nè
okla	ok
gảnk	rảnh
gòy	rồi
shoppp	shop
trật	chật
luk	lúc
Hành đepj	hàng đẹp
laii	lại
tot	tốt
nhanhhhhhhhhhhhhhhhhhhhhhhhhhhhhhh	nhanh
dvvc	dịch vụ vận chuyển
dầy	dày
m.nneen	mọi người nên
mìh	mình
đẹppppppl	đẹp
tiếppppppploppppppll	tiếp
thời giản	thời gian
lắmmmmmmmmmmmmmmmmmmmmmmmmmmmmmmmmmmm	lắm
tóan	toán
đựocw	được
vllv	vờ lờ
khôngg	không
khôgn	không
phaiii	phai
vơis	với
máttt	mát
muaaaa	mua
tuyệtttttttttttttttttttttttttt	tuyệt
lâuu	lâu
hịn	xịn
tiềnn	tiền
xinhhhh	xinh
bonux	thêm
lựi	lại
nz	như vậy
nhât	nhất
nênn	nên
tuyệt zời	tuyệt vời
dàiii	dài
vchhh	vãi chưởng
ương ý	ưng ý
măch	mặc
muk	mình
hìn	hình
nhưngggg	nhưng
ưnggggggggg	ưng
đẹpppppppppppppppp	đẹp
cyngws	cứng
ll	liên lạc
ng	người
vottttt	chọn
giâ	giá
xỉuuuuuuuuuuuuuu	xỉu
okelaaa	ok
áoooooooooooooooooooo	áo
đẹppppppppppooooopppo	đẹp
mìnhhhhhhhhhhhhhhhhhhhhhhhhhhhh	mình
nênnnnnnnnnn	nên
cácc	các
manggg	mang
đựtt	được 
đẹpppp	đẹp
mậc	mặc
ubgr	ủng
bónb	bóng
hưởnh	hưởng
check	kiểm tra
back	trả
okkkkkkkkkkkkkkklkllkkkkkkkkkkkkkko	ok
maud	màu
hìnhhhhhhhhhhhhhhhhhhhhhhhhhhhhjhhhhhhhhhhhhhhhhh	hình
qtrong	quan trọng
haiz	thở dài
sez	sẽ
đuets	đứt
pk	phải không
coa	có
nhue	như
ruii	rồi
honggg	không
hazzzzzzzzz	thở dài
bjet	biết
ưi	ơi
lứmmm	lắm
ord	đặt hàng
kphai	không phải
thui	thôi
huỷ	hủy
oke	ok
buoc	buộc
cungz	cũng
trươcs	trước
đủng	đũng
cug	cũng
sezi	size
cqanr	cẩn
mag	mang
nguoiyeu	người yêu
mogn	mong
luônnnnnnn	luôn
khácccc	khác
aluowngj	lượng
emmm	em
rôiiiiii	rồi
lg	lượng
sdung	sử dụng
tl	trả lời
nàylm	này làm
okokokokokok	ok
ngi	nghĩ
okk	ok
okila	ok
mỏngnsnskakakakaa	mỏng
huhu	buồn
okee	ok
haizzzzzzzzzzx	thở dài
đoeij	đợi
okkk	ok
uổg	uổng
cxcko	cũng không
đưpj	được
quẩn	quần
mỏg	mỏng
thạt	thật
đúg	đúng
siu	siêu
thạnks	cảm ơn
nhaaaaaaaaaa	nha
ncl	nói chung là
mỏngggggggggg	mỏng
okokokokokoko	ok
chat lg	chất lượng
ms	mới
ôk	ok
thcihs	thích
sịn	xịn
lắmmmm	lắm
thueonfg	thường
v	vậy
nhaaa	nha
đẹppppppppppppppppppppppppppppppppppppppppppppppppppppppppppppppppppppppppppppppppppppppppppppppppppppppppppppppp	đẹp
xau	xấu
ưnggggg	ưng
bt	bình thường
ơiiiiiio	ơi
sop	shop
sem	xem
thg	thường
quàn	quần
trx	trước
nxet	nhận xét
ko	không
tuid	túi
okiela	ok
đâú	dấu
giaoooooo	giao
chánnnnnnnnnnnnnnnnnnnnnn	chán
đánhhhhh	đánh
doạ	dọa
đẹpppppppppppppppppppppppppppppppppppppppppppppppppppppppppppppppppppppppppppp	đẹp
roiif	rồi
mỏngggggggggggggggggggggggggggggggggggggggggggggg	mỏng
haha	cười
tiềnnnnn	tiền
luon	luôn
tạmmmmmmm	tạm
sship	ship
lâujsjdbdhsjjwj	lâu
mayyyy	may
tuỵt	tuyệt
zờiiiiiii	vời
kt	kiểm tra
uđen	đen
okkkkkkkkkkkkkkkkkkkkkkkkkkkkkkkkkkkkkkkkkk	ok
huhuhu	buồn
okkkkkkkkk	ok
okk	ok
okkk	ok
okkkokkkk	ok
okkkk	ok
hiccc	buồn
tăngj	tặng
ntnay	như thế này
muaaaaa	mua
chănggggg	chăng
gh	giao hàng
đẹpppppppppppppppppppppppppppppppppppppppppppppppppppppppppppppppppppppppppppppppppppppppppppppppp	đẹp
đượcccxcccc	được
oiiii	ơi
nhie	nhe
nhìuuuu	nhiều
chờfvvvcvvvv	chờ
yc	yêu cầu
po táy	bó tay
okkkkkkkkkkkk	ok
hâhhahaha	cười
đềuu	đều
ổnn	ổn
gthieu	giới thiệu
tốttttttttttttttttttttttttttttttttttttttttttttttttttttttttttttttttttttttttttttt	tốt
vi	vì
xinhhhhhhhhh	xinh
hindh	hình
luoonnnnn	luôn
dcccccccccccxcccccccccccccfccccccc	được
sịn	xịn
saooooooooooooooooooookkkkkkkkkkkkkkkkkkkkkkkkkkkkkkkkkkkkk	sao
shoppe	shopee
khỏang	khoảng
quáaaaa	quá
kn	kinh nghiệm
kiểm trà	kiểm tra
đepj	đẹp
r	rồi
lmj	làm gì
saooooooooooooooo	sao
chx	chưa
bôk	bộ
đungs	đúng
phảm	phẩm
dc	được
qc	quảng cáo
đẹppppppooppooooopopoooooolllllpppppppppppppppppppppp	đẹp
giaoo	giao
nhanhhh	nhanh
đẹppp	đẹp
lsau	lần sau
hơp	hợp
chunggggg	chung
hànggggg	hàng
phànnnn	phàn
nànnnn	nàn
chungggg	chung
nhậnnnnn	nhận
xuuuuuuuuuuu	xu
nv	nhân viên
rathất	thất
nênmuanha	nên mua nha
đẹpppppppppppppppppppppppppppppppppppppppppppppppp	đẹp
nhah	nhanh
hích	buồn
gthich	giải thích
hải cái	hai cái
okkkkkkkkkkkkkkkkkkkkkkkkkkkkkkkkkkkkkkkkkkkkkkkkk.	ok
voeis	với
ỏe	ở
hicc	buồn
hazzzz	thở dài
cbi	chuẩn bị
oke	ok
okkkkkkkkkknsjajakdkkdndhajsmsnsjsjjwkmdndhdwjkwksksndjjcjdkwmsndjskwksm	ok
shopkhác	shop khác
quầnl	quần l
sizel	size l
lưgquần	lưng quần
kgiãn	không giãn
rôgi	rộng
sieuuuuuuudeppppppppppplunnnnnnnnnnnnnnnnnnnnnnnnn	siêu đẹp luôn
tôttttttttttttttttttttbhhb	tốt
hêhheeee	cười
vnxk	việt nam xuất khẩu
thấy vọng	thất vọng
lâm	lắm
snhaajj	nhận
nóngggg	nóng
nhg	nhưng
vânc	vẫn
lôg	lông
shoper	shipper
đưm	đem
toẹt vời nuôn	tuyệt vời luôn
xinhhhhhhhhh	xinh
thườnggggggggggggggggggggggggggggggggggg	thường
lunnnnn	luôn
rùi	rồi
ukiii	ok
ntin	nhắn tin
nhanhhhh	nhanh
rất dẹp	rất đẹp
derlay	hoãn
nhg	nhưng
vc	vãi chưởng
luoonnnnn	luôn
ck	chồng
nx	nhận xét
ngonnnnnnnnnn	ngon
phếttttttttttttttttttttttttt	phết
ổndjdnxnxjxnxnxncncncncnbdhdbxbxbxnxnxnxnxnxnxncncnc	ổn
tuỵtttttttttttt	tuyệt
nèeeeeeeee	nè
trờiiiiiiiii	trời
ơiiiiiiiiiii	ơi
đẹpppppopppppppooppppppppppppppppppppppppppppppppppp	đẹp
giốnh	giống
déign	thiết kế
rấtttt	rất
nhaaaa	nha
zời	vời
tì	thì
hagg	hàng
chata lươngk	chất lượng
ưnggg	ưng
thừà	thừa
ôiiiiiiii	ơi
okkkkkkkkkkkkkkkkkkkkkkkkkkkkkkkkkkkkkkkkkkkkkkkkkkkkkkkkk	ok
đâuuuu	đâu
nhanhhh	nhanh
okeeeeeeeeeeeeeeeeeeeeeeeeeeeeeeeeeeeeeeeeeeeeeeee	ok
lun	luôn
đẹppppppppppppppppppppppppppppppppppppppppppppppp	đẹp
quáaaa	quá
ạa	ạ
thuoewnfg	thường
thánks	cảm ơn
okkkkkkkkkkkkkkkkkkkkkkkkkkkkkkkklllllllllllklklll	ok
guao	giao
ch	chưa
nhmà	nhưng mà
okkkkkeellaaaaaaaaaaaa	ok
phẩmmm	phẩm
nhaaaaaa	nha
saoooo	sao
dịchhh	dịch
liênnn	liên
lhe	liên hệ
ýyyy	ý
thaoir	thoải
đbiet	đặc biệt
cubgx	cũng
sử lý	xử lý
kemmmmmmmmmmmmmmmmmmmmmmmmmmmmmmmmmmmmmmmmmmmmmmmmmmmmmmm	kém
rôngh	rộng
okmmmmmmmmmmmmmmmmmmmmmmmmmmmmmmmmmmmmmmmmmmmmmmmmmmmmmmmmmmmmmmmmmmmmmmmmmmmmmmmmmmmmmmmmmm	ok
dugng	dùng
liên quân	liên quan
hdsd	hướng dẫn sử dụng
hssv	học sinh sinh viên
ukila	ok
suts	sút
bthgggggggggggggggggggggggggggggggggggggggggggggggggggggggggggggggggggggggggggggggg	bình thường
kbiet	không biết
okkkkkllkkkkkkkkkkkkkkkkkkkkkkklkmkkkklkklllllllllk	ok
ưnggg	ưng
ktl	không trả lời
vlin	vờ lờ
pr	quảng cáo
saoknnhhjhhvvcSdtujjnnnbbbbbbb	sau
okeeee	ok
roàii	rồi
khônh	không
rivew	đánh giá
okie	ok
gửu	gửi
vvaaxn	vẫn
dell	đép
dth	dễ thương
unbox	mở hộp
mann	man
phaamr	phẩm
cbij	bị
xinhhhhhhhjjjjjjjjjjjjjjjjjjjjj	xinh
okkkkkkkkkkksveh	ok
gthiệu	giới thiệu
tụkkk	tức
nhưbg	nhưng
cỉa	của
sản phầm	sản phẩm
oki	ok
minjn	mịn
thowm	thơm
lad	là
nưaz	nữa
nnois	nói
chumg	chung
ời	rồi
tr	trời
spham	sản phẩm
shipper	người giao hàng
thick	thích
lũn	lủng
dm	đờ mờ
max	rất
haizx	thở dài
ưi	ơi
sory	xin lỗi
=(((	buồn
nênnnnrmuaaaaaaaa	nên mua
okela	ok
nh mà	nhưng mà
mjk	mình
bửn	bẩn
trl	trả lời
sd	sử dụng
đặy	đặt
giôq	giống
khoaq	khoảng
oki	ok
hihihi	cười
hag	hàng
chưs	chứ
tnao	thế nào
huhuhuhuhu	khóc
hihi	cười
lứm	lắm
okokokokok	ok
lượny	lượng
đek	đẹp
ổnnnnnnnnnnnnnnnmmnnmmmmmmmmmmmmm	ổn
nhìu	nhiều
lquan	liên quan
khảu	khẩu
fai	phải
love	yêu
tks	cảm ơn
thuii	thôi
overrated	đánh giá cao
đpej	đẹp
dethuong	dễ thương
vote	đánh giá
tiếpppoppppppppppppppppppp	tiếp
bk	biết
thank	cảm ơn
okeeeeeeeeeeeeee	ok
xynh	xinh
đgia	đánh giá
thìbinhthuong	thì bình thường
chánnnnnnnnnnnnnnnnnnnnnnnnnnnnnnnnnnnnnnnnnnnnnnnnnnnnnnnibbvhjj	chán
xời	trời
đấyh	đấy
nóngnhgxgdhgdshhegdggsggsgssgagaggsvvsvsvsvvssvsvgssggsgsshhshsgsgshshshshgegewhehe	nóng
le:vvv	le
thankkkkkkk	cảm ơn
okeeeeerrrrr	ok
made	làm
fake	giả
nkaaa	nha
lg	lượng
free	miễn phí
đeoi	đẹp
tệhdhdjdjdjjdvvshajsns	tệ
tẹt	tuyệt
quáaaaa	quá
đjeppp	đẹp
nah	nà
sù	xù
nhày	nhàu
bấn	bẩn
tip	tiếp
mỏibbb	mỏi
đep	đẹp
oi	ơi
rùi	rồi
bye	tạm biệt
good	tốt
say	nói
hiccccc	buồn
hic	buồn
huhuhuhuhuhuhuhuhuhuhuhuhuhuhuhu	buồn